111111111111111111111
10000000CC00000C00001
111001010000000010101
10100100100E001000101
10000000C00C00P000001
111111111111111111111